North Chesterfield VA - Mall Dr
Newport News VA - Jefferson Ave
Suffolk VA - Harbour View Blvd
Winston Salem NC - Sides Branch Rd
Indian Land SC - Charlotte Hwy
Rock Hill SC - Herrons Ferry Rd
Richmond VA - S Laburnum Ave
Aberdeen MD - Philadelphia Blvd
Bowie MD - Annapolis Rd
Danville VA - Piedmont Place
Goose Creek SC - Saint James Ave
Henrico VA - Hermitage Rd
Union NJ - Route 22
Lexington SC - Sunset Blvd
Greenwood SC - 72 Bypass NW
Middletown DE - Auto Park Dr
Manassas VA - Sudley Manor Dr
Hazlet NJ - NJSH 35
Greensboro NC - W Gate City Blvd
Royersford PA - Ridge Pike
Virginia Beach VA - Holland Rd
Dover DE - N DuPont Hwy
Lacey NJ - US 9
Jonesboro GA - Tara Blvd
Richmond VA - W Broad St
Folsom PA - MacDade Blvd
Lawrenceville GA -Sugarloaf Parkway
Springfield VA - Commerce Street
Snellville GA - Stone Mountain Highway
Chattanooga TN - Lakeview St.
Sugar Land TX - St Louis St.
Middle River MD - 8th Lane
Sunnyside NY - Newbridge Ave.
Hollis NY - Lakeshore St.
Lititz PA - South Logan St.
Holbrook NY - Brewery St.
Torrance CA - Crescent St.
Jonesboro GA - St Louis Street
Naples FL - Carpenter Street
Dalton GA - Colonial Drive
Maryville TN - Pilgrim Rd.
Stafford VA - Boston Street
Greenfield IN - Philmont Street
Waukegan IL - Princess St.
Greensburg PA - Thatcher Lane
Taunton MA - 4th St.
Mountain View CA - South Williams Ave.
Rockaway NJ - Miller Dr.
Fleming Island FL - East Talbot Street